HEROP_ID,StateArea,TradFedExp,TradSttExp,ExpnFedExp,ExpnSttExp,CrrctExpS,PlcFyrExpS,HlthExpS,WlfrExpS,CrrctExpL,PlcFyrExpL,HlthExpL,WlfrExpL,CrrctExpT,PlcFyrExpT,HlthExpT,WlfrExpT
040US28,1506882006.0,4011296400,1284335200,,,407751,135917.0,407751,815502,558639.0,925545.0,558639.0,1117278.0,966390,1061462,966390,1932780
040US37,1285921961.0,8944059000,4257401500,,,1598229,532743.0,1598229,3196458,1675407.0,3722009.0,1675407.0,3350814.0,3273636,4254752,3273636,6547272
040US40,2351000913.0,2944575400,1912258300,,,530334,176778.0,530334,1060668,459852.0,1411278.0,459852.0,919704.0,990186,1588056,990186,1980372
040US51,787902871.4,4637762600,4645842000,,,1221636,407212.0,1221636,2443272,3570756.0,3489010.0,3570756.0,7141512.0,4792392,3896222,4792392,9584784
040US54,1140159488.0,2042181600,745927900,908272700.0,58486100.0,243093,81031.0,243093,486186,157695.0,435074.0,157695.0,315390.0,400788,516105,400788,801576
040US22,1910198658.0,5087538500,2879179700,2527183400.0,154503700.0,728616,242872.0,728616,1457232,1443519.0,2166712.0,1443519.0,2887038.0,2172135,2409584,2172135,4344270
040US26,1816027545.0,8119737900,4415242500,3573748200.0,305218900.0,1420932,473644.0,1420932,2841864,1852605.0,3055552.0,1852605.0,3705210.0,3273537,3529196,3273537,6547074
040US25,1515618384.0,7648074800,7621002500,1896927000.0,241498200.0,2568345,856115.0,2568345,5136690,0.0,3026686.0,0.0,0.0,2568345,3882801,2568345,5136690
040US16,4908907421.0,1414507000,571264800,,,191931,63977.0,191931,383862,428508.0,614081.0,428508.0,857016.0,620439,678058,620439,1240878
040US12,2256248805.0,14473538300,8903420700,,,1819119,606373.0,1819119,3638238,5889987.0,11925508.0,5889987.0,11779974.0,7709106,12531881,7709106,15418212
040US31,2151102405.0,1113354300,1002487900,,,247611,82537.0,247611,495222,428370.0,661579.0,428370.0,856740.0,675981,744116,675981,1351962
040US53,4486028684.0,4610569600,4349828600,2902387900.0,174679300.0,915105,305035.0,915105,1830210,2196606.0,3385247.0,2196606.0,4393212.0,3111711,3690282,3111711,6223422
040US35,9544849063.0,2684197500,1000889800,1344329700.0,78558100.0,375543,125181.0,375543,751086,710391.0,895515.0,710391.0,1420782.0,1085934,1020696,1085934,2171868
040US46,3019857729.0,534232200,361464900,,,134268,44756.0,134268,268536,186960.0,234435.0,186960.0,373920.0,321228,279191,321228,642456
040US48,2709920286.0,21932283600,16431615100,,,3689850,1229950.0,3689850,7379700,7708710.0,10346638.0,7708710.0,15417420.0,11398560,11576588,11398560,22797120
040US06,7063958716.0,36497606700,35151528200,17251390500.0,1043709100.0,5647680,1882560.0,5647680,11295360,18713541.0,25783987.0,18713541.0,37427082.0,24361221,27666547,24361221,48722442
040US01,1999581060.0,4014987200,1583459000,,,501051,167017.0,501051,1002102,642843.0,1609448.0,642843.0,1285686.0,1143894,1776465,1143894,2287788
040US13,960219902.1,7329941100,3338729800,,,1249401,416467.0,1249401,2498802,2491740.0,3493626.0,2491740.0,4983480.0,3741141,3910093,3741141,7482282
040US42,1749164284.0,12987200700,12041942900,4503641400.0,289150600.0,3245916,1081972.0,3245916,6491832,4721220.0,3629833.0,4721220.0,9442440.0,7967136,4711805,7967136,15934272
040US29,1568884482.0,6799087300,3652338300,,,822222,274074.0,822222,1644444,639198.0,2401509.0,639198.0,1278396.0,1461420,2675583,1461420,2922840
040US08,4209023352.0,3812195000,3792747500,1525136400.0,99404300.0,578478,192826.0,578478,1156956,1402407.0,2693737.0,1402407.0,2804814.0,1980885,2886563,1980885,3961770
040US49,7575439943.0,1744439700,736059500,,,450945,150315.0,450945,901890,557298.0,907989.0,557298.0,1114596.0,1008243,1058304,1008243,2016486
040US47,1148820223.0,6529389900,3315781800,,,669087,223029.0,669087,1338174,1315068.0,2526743.0,1315068.0,2630136.0,1984155,2749772,1984155,3968310
040US56,10994820913.0,317569300,285861900,,,118392,39464.0,118392,236784,210957.0,280918.0,210957.0,421914.0,329349,320382,329349,658698
040US36,2044604411.0,39032126500,38173138700,431408500.0,60507400.0,2595894,865298.0,2595894,5191788,10207965.0,13459750.0,10207965.0,20415930.0,12803859,14325048,12803859,25607718
040US20,2028044622.0,1905097100,1565239900,,,323604,107868.0,323604,647208,697572.0,1108566.0,697572.0,1395144.0,1021176,1216434,1021176,2042352
040US02,52177139592.0,1088386100,576420900,398204400.0,14790200.0,349572,116524.0,349572,699144,19371.0,489925.0,19371.0,38742.0,368943,606449,368943,737886
040US32,16830294016.0,1783583900,922486900,1181644500.0,71748600.0,265440,88480.0,265440,530880,1397259.0,1731653.0,1397259.0,2794518.0,1662699,1820133,1662699,3325398
040US17,1429030796.0,8592722500,8288756400,4403251600.0,1030762100.0,1227459,409153.0,1227459,2454918,2179767.0,7527125.0,2179767.0,4359534.0,3407226,7936278,3407226,6814452
040US50,1775172444.0,737040700,638664500,196733000.0,23709600.0,312243,104081.0,312243,624486,1371.0,186062.0,1371.0,2742.0,313614,290143,313614,627228
040US30,6782457892.0,778706500,369979800,648026400.0,42393800.0,114483,38161.0,114483,228966,137052.0,415817.0,137052.0,274104.0,251535,453978,251535,503070
040US19,1469882899.0,2318971200,1640684800,961083900.0,84262600.0,286545,95515.0,286545,573090,445464.0,988953.0,445464.0,890928.0,732009,1084468,732009,1464018
040US45,1752456144.0,4465172700,1764679000,,,541773,180591.0,541773,1083546,792183.0,1715571.0,792183.0,1584366.0,1333956,1896162,1333956,2667912
040US33,2399265024.0,859950400,858495400,478774900.0,31610000.0,212742,70914.0,212742,425484,240462.0,607695.0,240462.0,480924.0,453204,678609,453204,906408
040US04,19686821200.0,6371629300,2523317200,2653909200.0,220292800.0,754293,251431.0,754293,1508586,1848045.0,3429846.0,1848045.0,3696090.0,2602338,3681277,2602338,5204676
040US11,176787002.2,1634749600,701938800,417278500.0,26229700.0,0,,0,0,,,,,0,0,0,0
040US34,958471006.1,5999339800,5910689800,2985600500.0,184315000.0,1860483,620161.0,1860483,3720966,2118744.0,3980848.0,2118744.0,4237488.0,3979227,4601009,3979227,7958454
040US24,1109326654.0,4436728700,4374220100,2544578800.0,155206200.0,1639605,546535.0,1639605,3279210,1313001.0,3301963.0,1313001.0,2626002.0,2952606,3848498,2952606,5905212
040US23,5294099446.0,1787971900,986758900,,,271104,90368.0,271104,542208,293139.0,387204.0,293139.0,586278.0,564243,477572,564243,1128486
040US15,3359454869.0,890604900,734972600,611344700.0,45177700.0,134631,44877.0,134631,269262,0.0,693798.0,0.0,0.0,134631,738675,134631,269262
040US10,1734973880.0,987366600,761443100,514715800.0,55176500.0,440268,146756.0,440268,880536,0.0,270786.0,0.0,0.0,440268,417542,440268,880536
040US44,568444037.4,1110545900,1044021800,424670000.0,26046300.0,278499,92833.0,278499,556998,0.0,696596.0,0.0,0.0,278499,789429,278499,556998
040US21,871682842.9,5067931400,2045343300,2901052000.0,178014900.0,726039,242013.0,726039,1452078,913584.0,977663.0,913584.0,1827168.0,1639623,1219676,1639623,3279246
040US39,1213045207.0,11343081300,6715231000,3887798400.0,236640500.0,998547,332849.0,998547,1997094,1514334.0,5526212.0,1514334.0,3028668.0,2512881,5859061,2512881,5025762
040US55,2014617098.0,7095802600,4938282500,,,134340,44780.0,134340,268680,1631865.0,2541133.0,1631865.0,3263730.0,1766205,2585913,1766205,3532410
040US41,6967823002.0,4315998200,2268454100,2363583800.0,145836300.0,600183,200061.0,600183,1200366,1629090.0,1966587.0,1629090.0,3258180.0,2229273,2166648,2229273,4458546
040US38,3445244575.0,494032100,474269300,274231400.0,23418800.0,105756,35252.0,105756,211512,364725.0,323969.0,364725.0,729450.0,470481,359221,470481,940962
040US05,1836606158.0,3228811200,1323965200,1739970200.0,107649400.0,317061,105687.0,317061,634122,531165.0,870184.0,531165.0,1062330.0,848226,975871,848226,1696452
040US18,1017717910.0,6101336100,3197243000,3043033400.0,449860700.0,670386,223462.0,670386,1340772,1288020.0,2104036.0,1288020.0,2576040.0,1958406,2327498,1958406,3916812
040US27,2505976540.0,5602849400,5472277900,1708089800.0,100419200.0,1071069,357023.0,1071069,2142138,1649442.0,2112958.0,1649442.0,3298884.0,2720511,2469981,2720511,5441022
040US09,1613697223.0,3270834800,3257617600,1822845100.0,228545700.0,669357,223119.0,669357,1338714,0.0,1582453.0,0.0,0.0,669357,1805572,669357,1338714
